Rank,Player,Total Win,Total Games,Reg Win,Playoff Teams,Playoff Win,Total Win%
1,Brandon,238,438,229,10,9,54.3
2,Alex,235,440,227,13,8,53.4
3,Jordan,226,440,212,10,14,51.4
4,Jackson,220,412,209,11,11,53.4
4,JP,220,435,211,9,9,50.6
6,Mike,217,431,212,8,5,50.3
7,Dan,213,433,209,10,4,49.2
8,Leftover,105,332,100,4,5,31.6
9,Victoria,56,101,52,3,4,55.4
10,Cameron,10,27,10,0,0,37.0
