Rank,Player,Total Win,Total Games,Reg Win,Playoff Teams,Playoff Win,Total Win%
1,Brandon,243,450,234,10,9,54.0
2,Alex,238,453,230,13,8,52.5
3,Jordan,232,450,218,10,14,51.6
4,JP,227,447,218,9,9,50.8
5,Mike,221,442,216,8,5,50.0
6,Jackson,220,412,209,11,11,53.4
7,Dan,219,444,215,10,4,49.3
8,Leftover,105,332,100,4,5,31.6
9,Victoria,62,111,58,3,4,55.9
10,Cameron,18,38,18,0,0,47.4
