Rank,Player,Total Win,Total Games,Reg Win,Playoff Teams,Playoff Win,Total Win%
1,Brandon,240,442,231,10,9,54.3
2,Alex,236,444,228,13,8,53.2
3,Jordan,228,444,214,10,14,51.4
4,JP,223,439,214,9,9,50.8
5,Jackson,220,412,209,11,11,53.4
6,Mike,218,435,213,8,5,50.1
7,Dan,215,436,211,10,4,49.3
8,Leftover,105,332,100,4,5,31.6
9,Victoria,57,104,53,3,4,54.8
10,Cameron,13,31,13,0,0,41.9
