Rank,Player,Total Win,Total Games,Reg Win,Playoff Teams,Playoff Win,Total Win%
1,Brandon,256,468,247,10,9,54.7
2,Alex,248,472,240,13,8,52.5
3,Jordan,241,474,227,10,14,50.8
4,JP,240,469,231,9,9,51.2
5,Dan,231,466,227,10,4,49.6
6,Mike,228,464,223,8,5,49.1
7,Jackson,220,412,209,11,11,53.4
8,Leftover,105,332,100,4,5,31.6
9,Victoria,76,132,72,3,4,57.6
10,Cameron,25,60,25,0,0,41.7
