Rank,Player,Total Win,Total Games,Reg Win,Playoff Teams,Playoff Win,Total Win%
1,Brandon,246,453,237,10,9,54.3
2,Alex,239,456,231,13,8,52.4
3,Jordan,234,454,220,10,14,51.5
4,JP,230,451,221,9,9,51.0
5,Mike,222,446,217,8,5,49.8
6,Jackson,220,412,209,11,11,53.4
6,Dan,220,447,216,10,4,49.2
8,Leftover,105,332,100,4,5,31.6
9,Victoria,64,114,60,3,4,56.1
10,Cameron,18,40,18,0,0,45.0
