Rank,Player,Total Win,Total Games,Reg Win,Playoff Teams,Playoff Win,Total Win%
1,Brandon,252,462,243,10,9,54.5
2,Alex,243,464,235,13,8,52.4
3,Jordan,240,466,226,10,14,51.5
4,JP,237,461,228,9,9,51.4
5,Mike,226,456,221,8,5,49.6
6,Dan,225,458,221,10,4,49.1
7,Jackson,220,412,209,11,11,53.4
8,Leftover,105,332,100,4,5,31.6
9,Victoria,69,124,65,3,4,55.6
10,Cameron,22,52,22,0,0,42.3
